1111111
1P0C0E1
1C00001
1000E01
1111111
