1111111
1P0C001
1C00001
1P00E01
1111111
