1111111111111111111111111111111111111
1E0000000000000C00000C000100000000001
1100111100100000101001000100010111111
1P11000010101010001001000100000C00001
1010010010101010001001000100010000101
10100100101010100010010001000000C0001
1010010010101010C01001000100010100001
1010001010101010000111000100010000101
100001000C00C0000011110000010000010C1
1000011100000000C00000000000000011001
1111111111111111111111111111111111111
