1111111111111111111111111111111111
10000000C00000010000100000001E0P11
1010010100100000101000000000C00101
111C010010101010001001000000111101
1000000000001110000110000001000101
10000C0000000000001110000000000001
11000000C0000000000011110000000001
1000000000000001111000000000000001
1111111111111111111111111111111111
