1110000000000000000000001111111111
10000000C00000010000100000001E0P11
1010010100100000101001000001C00101
111C010010101010001001000000111101
1000000000001110000000000001000101
1111111111111111111111111111111111
