11111111111111111111111111111111111111111111111111111111111111111111111111111111111111111111111111111
1E0000000000000C00000C0000000000000000000000000000000000000000000000000000000000000000000100000000001
11001111001000001010010000000000000000000000000000000000000000000000000000000000000000000100010111111
1P11000010101010001001000100000C000000000000000000000000000000000000000000000000000000000000000000001
10100100101010100010010001000100001000000000000000000000000000000000000000000000000000000000000000001
10100100101010100010010001000000C00000000000000000000000000000000000000000000000000000000000000000001
1010010010101010C010010001000101000000000000000000000000000000000000000000000000000000000000000000001
10100010101010100001110001000100001000000000000000000000000000000000000000000000000000000000000000001
100001000C00C00000111100000100000100000000000000000000000000000000000000000000000000000000000000000C1
1000011100000000C000000000000000110000000000000000000000000000000000000000000000000000000000000000001
11111111111111111111111111111111111111111111111111111111111111111111111111111111111111111111111111111
