11111111111111111111111111
10000000C000100000000E0P11
10100000101001000001C00101
11101010001001000000111101
10001110000000000001000101
111C0000000000011C00000001
10000000000C00000000000111
10000000110C11000000000001
11111111111111111111111111
