11111111
1P0C001
1C000001
1000E01
1111111
