1111111
1P0C001
1C000A1
1000EB1
1111111
